#################
#################
##    #G       ##
##    #        ##
####  #######D###
##    T #     R##
## ######      ##
##      #      ##
##L           T##
##     ##########
##FFFF     WWWW##
##FFFF     WWWW##
##FFFF  T  WWWW##
#################
#################
>
2 2 START 
5 6 TOKEN
12 8 TOKEN
8 14 TOKEN
4 13 T 3
5 14 ENEMY WALL DOWN RIGHT
8 2 ENEMY LINE LEFT