#################
#################
##    #G       ##
##    #        ##
####  #######D###
##    I #      ##
## ######      ##
##      #      ##
##            I##
##     ##########
##FFFF     WWWW##
##FFFF     WWWW##
##FFFF  I  WWWW##
#################
#################
>
2 2 START 
5 6 TOKEN
12 8 TOKEN
8 14 TOKEN
4 13 T 3
5 14 ENEMY WALLHUGGER downRight
8 2 ENEMY STRAIGHT RIGHT
