############
############
##     # G##
###### # ###
##   # #  ##
## # # ##P##
## # # #####
## #   ##P##
## ######D##
## #   #I ##
##L  # ## ##
##   #    ##
############
############
>
2 2 START 
7 8 K RED
8 7 KEY RED
7 9 5 9 
5 9 7 9
10 2 ENEMY LINE RIGHT