############
############
##     # G##
###### # ###
##   # #  ##
## # # ##P##
## # # #####
## #   ##P##
## ######D##
## #   #I ##
##   # ## ##
##   #    ##
############
############
>
2 2 START 
8 9 K RED
9 8 KEY RED
7 9 5 9 
5 9 7 9
10 2 ENEMY STRAIGHT UP
