#################
#################
##?   #G       ##
##    #        ##
####  #######D###
##I     #I     ##
##      #      ##
##      #L     ##
##L            ##
##        #######
##FFFFF   WWWWW##
##  I F   W I  ##
##    F   W    ##
#################
#################
>
2 2 START
5 2 FIRE_BOOTS
5 9 FLIPPER
4 13 T 2
11 4 TOKEN
11 12 TOKEN
