##########
#     # G#
##### # ##
#   # #  #
# # # ##P#
# # # ####
# #   ##P#
# ######D#
# #   #I #
# # # ## #
#   #    #
##########
>
1 1 START 
7 8 K RED
8 7 KEY RED
6 8 4 8 
4 8 6 8