##########################################
#                                        #
#III D                                   #
#                                        #
#                                        #
##########################################
>
1 1 START 
2 1 TOKEN
2 2 TOKEN
2 3 TOKEN
2 5 T 3